気の置けない関係	不置气（斗斗嘴）的关系
くっつきすぎだ	贴的太紧了
すぐ目前にある  就在眼前
コンディショナー  conditioner 护发素
思いつめる  钻牛角尖
めげずに　　不气馁

「なので」
私は今風邪をひいている。なので、今日の集まりには参加できそうにない。	所以
それが綾音なのではないか  なので（就，该） 那不会就是凌音吧
	--不尊敬的意味，可以使用「ですので」


凍り付き  こおりつき　　冻结
あっと言う間に  转眼间

ビビり		胆小鬼
ビビった	被。。。吓一跳

着メロ	铃声

受験生	じゅけんせい		考生

稲貰		いねもらい	稻穗

告ぐ	つぐ	告知

救われる	すくわれる

飛びつく	扑向去

早上がり（狩り）	早退

しゃがみ込む	蹲着·

さまぐれ	心血来潮

高画質	こうがしつ

招かれざる	　不请自来

エゴ	自我
エコ	生态

事件		案件【多指犯罪事件】
記事		消息，新闻
事情		原因

モノポリー	大富翁

省エネ	节能

アポ		appointment		约定

払っとく	支付
支払い